----------------Comandos Practicos Para el Ejecutor------------




***********************Comandos para mostrar información del sistema*******************

MSINFO32:	Mostrará toda la información relativa al sistema y al hardware que tenemos instalado en nuestro equipo.
WINVER:		Mostrará la información acerca de la versión actual de Windows que tenemos instalada
TELEPHON.CPL:	Abre la información acerca de la localización del sistema operativo
DXDIAG:		Abre la herramienta de diagnóstico de DirectX
PERFMON:	Abre el monitor de rendimiento
 

*****************Comandos en Windows 10 para abrir aplicaciones de Windows**************


MAGNIFY:	Abre la herramienta Lupa
OSK:		Abre el teclado virtual
CALC:		Abre la calculadora
SNIPPINGTOOL:	Abre la herramienta de recortes
NOTEPAD:	Abre el bloc de notas
WRITE:		Abre el Wordpad
TABTIP:		Abre el panel de escritura táctil de Windows
STIKYNOT:	Abre las notas rápidas
WMPLAYER:	Abre el Reproductor de Windows Media
DVDPLAY:	Abre el lector de DVD con Windows Media Player para su reproducción
SNDVOL:		Abre el mezclador de volumen
MSPAINT:	Abre la aplicación Paint
IEXPLORE:	Abre el navegador Internet Explorer
WINWORD:	Abre Microsoft Word en caso de tenerlo instalado
EXCEL:		Abre Microsoft Excel en caso de tenerlo instalado
MOVIEMK:	Abre Windows Movie Maker en caso de tenerlo instalado
MSTSC:		Abre el asistente de conexión a un escritorio remoto de Windows



******************Comandos para abrir utilidades de Windows**********************+

CMD:		Abre el símbolo del sistema
TASKMGR:	Abre el administrador de tareas
SERVICES.MSC:	Abre los servicios de Windows
EXPLORER:	Abre el explorador de carpetas de Windows
REGEDIT:	Abre el editor de registro del sistema
MRT:		Abre la herramienta de eliminación de software malintencionado de Microsoft
IEXPRESS:	Abre la herramienta de creación de archivos autoextraíbles de Windows
MSRA:		Abre el asistente de asistencia remota
MSDT:		Abre la herramienta de diagnóstico para el soporte técnico. Requiere una clave suministrada por el centro de soporte
MDSCHED:	Abre el comprobador de errores de memoria en Windows
EVENTVWR:	Abre el visor de eventos del sistema
MBLCTR:	Abre el centro de movilidad de Windows. Solo disponible en equipos portátiles
EUDCEDIT:	Abre la herramienta de edición de caracteres privados
SIGVERIF:	Abre el centro de comprobación de firmas de los archivos de Windows
CHARMAP:	Abre el mapa de caracteres
WAB:	Abra la carpeta de contactos de Windows
DIALER:	Abre el marcador de teléfono, útil cuando estamos en un dispositivo portátil
FSQUIRT:	Abre el asistente de transferencia de archivos por Bluetooth
IRPROPS.CPL:	Abre el dispositivo de infrarrojos que existe uno
HDWWIZ.CPL:	Abre el asistente para agregar un nuevos dispositivos hardware
CONTROL SCHEDTASKS:	Abre el programador de tareas de Windows
CERTMGR.MSC:	Abre la herramienta de certificados de usuario
ODBCAD32:	Abre el Administrador de orígenes de datos ODBC
CREDWIZ:	Abre el asistente de copias de seguridad de usuarios y contraseñas
SHUTDOWN (CMD):	Ejecuta el comando para apagar el sistema
LOGOFF (CMD):	Ejecuta el comando para cerrar la sesión del usuario activo


**************************+Comandos de gestión de unidades de almacenamiento*****************

DISKPART:	Abre la herramienta de particiones y configuración de discos
CHKDSK (CMD):	Ejecuta el comando de análisis y corrección de errores de discos duros
SFC (CMD):	Ejecuta el comando de escaneo y reparación de archivos del sistema
DEFRAG:	Abre la herramienta de optimización y desfragmentación de discos duros
CLEANMGR:	Abre la herramienta para liberar espacio en el disco


*****************************Comandos de configuración*************************

ncpa.cpl:  	Para abrir Panel de configuracion de red.
CONTROL USERPASSWORDS:	Abre la ventana de configuración de cuentas de usuario del panel de control
CONTROL:	Abre el panel de control
CONTROL ADMINTOOLS:	Abre la carpeta de herramientas administrativas para Windows
CONTROL FOLDERS:	Abre los opciones del explorador de archivos y carpetas
CONTROL COLOR:	Abre al configuración de apariencia y personalización de Windows
CONTROL KEYBOARD:	Abre las propiedades del teclado
CONTROL MOUSE:	Abre las propiedades del mouse
CONTROL FONTS:	Abre las fuentes instaladas en Windows
CONTROL PRINTERS:	Abre los dispositivos e impresoras del panel de control
COMPUTERDEFAULTS:	Abre al configuración de aplicaciones predeterminadas
MSCONFIG:	Abre la configuración de inicio y arranque del sistema
RSTRUI:		Abre el asistente de restauración del sistema Windows
NETPLWIZ:	Abre la configuración avanzada de cuentas de usuario
INTL.CPL:	Abre la configuración de Región e idioma
APPWIZ.CPL:	Abre la herramienta de desinstalación de programas del panel de control
DESK.CPL:	Abre la configuración de propiedades de pantalla
SYSDM.CPL:	Abre las propiedades del sistema
POWERCFG.CPL:	Abre la configuración de opciones de energía del panel de control
JOY.CPL:	Abre los dispositivos de juegos instalados en el sistema
MMSYS.CPL:	Abre las propiedades de los dispositivos de audio y sonido
TIMEDATE.CPL:	Abre las propiedades de fecha y hora del sistema
WSCUI.CPL:	Abre el centro de opciones de seguridad y mantenimiento
FSMGMT.MSC:	Abre la configuración de carpetas compartidas con otros usuarios
COMPMGMT.MSC:	Abre el administrador de equipos
DEVMGMT.MSC:	Abre el administrador de dispositivos
GPEDIP.MSC:	Abre el editor de directivas de grupo
LUSRMGR.MSC:	Abre la ventana de usuarios y grupos locales
SECPOL.MSC:	Abre las directivas de seguridad local
RSOP.MSC:	Abre el conjunto resultante de directivas de Windows
WMIMGMT.MSC:	Abre la consola Raiz/control WMI de Windows
MMC:		Abre una consola de configuración
TPM.MSC:	Abre el administrador del módulo de plataforma segura en Windows
UTILMAN:	Abre el administrador de utilidades de Windows
CLICONFG:	Abre el administrador del comprobador de controlador
SLUI:	Abre la configuración de activación de Windows
VERIFIER:	Abre el administrador del comprobador de controladores
MOBSYNC:	Abre en centro de sincronización
REKEYWIZ:	Abre el asistente para la administración de certificados de cifrado de archivos


******Visita esta pagina para mas comandos******
https://www.profesionalreview.com/2018/11/07/comandos-windows-10/